▩ ▩ ▩ ▩ ▩ ▩ ▩ ▩ ◎ ▩ ▩ ▩ ▩ ▩ ▩ ▩ ▩
▩ ▢ ▢ ▢ ▩ ▩ ▢ ▢ ▢ ▩ ▩ ▢ ▢ ▢ ▢ ▢ ▩
▩ ▢ ▩ ▢ ▢ ▢ ▢ ▩ ▢ ▢ ▢ ▢ ▩ ▩ ▩ ▢ ▩
▩ ▢ ▢ ▩ ▩ ▢ ▩ ▩ ▢ ▩ ▩ ▢ ▩ ▢ ▢ ▢ ▩
▩ ▩ ▩ ▢ ▩ ▢ ▢ ▢ ▢ ▩ ▩ ▩ ▢ ▩ ▩ ▢ ▩
▩ ▩ ▩ ▢ ▩ ▩ ▩ ▩ ▩ ▢ ▢ ▢ ▩ ▩ ▩ ▢ ▩
▩ ▢ ▢ ▢ ▢ ▢ ▢ ▢ ▢ ▢ ▩ ▢ ▢ ▢ ▢ ▢ ▩
▩ ▢ ▩ ▩ ▩ ▩ ▢ ▩ ▩ ▢ ▩ ▩ ▩ ▢ ▩ ▩ ▩
▩ ▢ ▢ ▢ ▢ ▩ ▢ ▩ ▩ ▩ ▢ ▩ ▩ ▢ ▩ ▢ ▩
▩ ▩ ▩ ▢ ▩ ▩ ▢ ▢ ▢ ▢ ▢ ▩ ▩ ▢ ▢ ▢ ▩
▩ ▢ ▩ ▢ ▢ ▢ ▢ ▩ ▩ ▩ ▩ ▩ ▩ ▩ ▢ ▩ ▩
▩ ▢ ▢ ▢ ▩ ▩ ▢ ▩ ▢ ▢ ▢ ▢ ▢ ▩ ▢ ▢ ▩
▩ ▩ ▩ ▢ ▩ ▩ ▢ ▩ ▩ ▩ ▢ ▩ ▢ ▢ ▩ ▢ ▩
▩ ▢ ▩ ▢ ▩ ▢ ▢ ▢ ▢ ▢ ▢ ▩ ▩ ▢ ▩ ▢ ▩
▩ ▢ ▢ ▢ ▩ ▩ ▩ ▩ ▢ ▩ ▢ ▢ ▢ ▢ ▢ ▢ ▩
▩ ▩ ▩ ▢ ▢ ▢ ▢ ▩ ▢ ▢ ▢ ▩ ▩ ▩ ▢ ▩ ▩
▩ ▩ ▩ ▩ ▩ ▩ ▩ ▩ ◉ ▩ ▩ ▩ ▩ ▩ ▩ ▩ ▩