▩▩▩▩▩▩▩▩◎▩▩▩▩▩▩▩▩
▩▢▢▢▩▩▢▢▢▩▩▢▢▢▢▢▩
▩▢▩▢▢▢▢▩▢▢▢▢▩▩▩▢▩
▩▢▢▩▩▢▩▩▢▩▩▢▩▢▢▢▩
▩▩▩▢▩▢▢▢▢▩▩▩▢▩▩▢▩
▩▩▩▢▩▩▩▩▩▢▢▢▩▩▩▢▩
▩▢▢▢▢▢▢▢▢▢▩▢▢▢▢▢▩
▩▢▩▩▩▩▢▩▩▢▩▩▩▢▩▩▩
▩▢▢▢▢▩▢▩▩▩▢▩▩▢▩▢▩
▩▩▩▢▩▩▢▢▢▢▢▩▩▢▢▢▩
▩▢▩▢▢▢▢▩▩▩▩▩▩▩▢▩▩
▩▢▢▢▩▩▢▩▢▢▢▢▢▩▢▢▩
▩▩▩▢▩▩▢▩▩▩▢▩▢▢▩▢▩
▩▢▩▢▩▢▢▢▢▢▢▩▩▢▩▢▩
▩▢▢▢▩▩▩▩▢▩▢▢▢▢▢▢▩
▩▩▩▢▢▢▢▩▢▢▢▩▩▩▢▩▩
▩▩▩▩▩▩▩▩◉▩▩▩▩▩▩▩▩